%%%%%%%%%%%%%%%%%%%%%%%%%
%%.....%%%%.....%%%%...%%
%..P %..  .. %%.. %....%%
%% % ..  %%%%%..% . ...%%
%%% .. %%%%%%..%%%%%...G%
%%%..%%%%%%%..%%%%%%...%%
%%.......%%.......%%...%%
%.......%%.......%%%...o%
%%%%%%%%%%%%%%%%%%%%%%%%%
